 
#                                                           #
#                                                           #
#               #####                                       #
#                      ####      ######                     #
#                                                           #
#                                        #####              #
#                                        #                  #
#                      #####         #####                  #
#                     ##             #                      #
#             ####   ##          #####                      #
#                   ##                                      #
#        ####                                               #
#                                                           #
#############################################################